1111111111111111
1000000014021051
1001101012100001
1030111012112101
1010120001100101
1000110100110121
1001000100120021
1001010100120121
1000010200020121
1000000000000121
1011111110010121
1222222100010021
1222221000100021
1051111101000021
1000000000000001
1111111111111111
