1111111111111111
1000000300000021
1011101122211101
1012200000000001
1010111111111101
1000000000001221
1011011111001221
1010012221001001
1010025252000001
1010012221001001
1010011111001001
1010000000001001
1010111111101221
1000122222101221
1000000000050241
1111111111111111